############
##  ### ### 
#         # 
# e       # 
#         # 
#         # 
#         # 
#         # 
#         # 
#         # 
#      e  # 
#         # 
#         # 
#         #
###########
