############
##  ### ### 
#         # 
#         # 
#         # 
#         # 
#         # 
#         # 
#         # 
#         # 
#         # 
#         # 
#         # 
#         #
###########
